1111111111111111111111111111111111
1000000000000000000000000000000001
1011111100000000000000000011111101
1000000000000000000000000000000001
1000000000000000000000000000000001
1000000000000000000000000000000001
1000000000000001000000000000000001
1000000000011101100000000000000001
1000000000010000100000000000000001
1000000000010000100002000000000001
1000000000011111100000000000000001
1000000000000000000000000000000001
1000000000000000000000000000000001
1000000000000000000000000000000001
1000000000000000000000000000000001
1000000000000000000000000000000001
1011111100000000000000000001111101
1000000000000000000000000000000001
1111111111111111111111111111111111
